XXXXXXXXXXXXXXXXXXXX
XO................OX
X.XXX.XXXX.XXXX.XX.X
X..................X
XXXXX.XXXXXXXX.XXXXX
    X....S.....X    
    X.XXXXXXXX.X    
XXXXX.X  G   X.XXXXX
     .XXXXXXXX.     
XXXXX..........XXXXX
    X.XXX.XXXX.X    
    X.X..P...X.X    
XXXXX.X.XXXX.X.XXXXX
XO.......XX.......OX
X.XX.XXX.XX.XXX.XX.X
X..X............X..X
XX...XXX.XX.XXX...XX
X..XXXXX.XX.XXXXX..X
X..................X
XXXXXXXXXXXXXXXXXXXX
                        "Not so original" by Dane