XXXXXXXX X XXXXXXXXX
X........X.........X
X.XXXXXXXXXXXXXXXX.X
X........X.........X
X.XXXX.X.X.XXXXXXXXX
X..O...X.X.X....O..X
XXXXXXXX.X.X.XXXXX.X
X........S.........X
X.X.XXXXXXX.XXXXXX.X
X.X.....X X........X
X.XXXXX.XGXXXXXX.X.X
X.X.....X X......X.X
X.X.XXXXXXX.XXXXXX.X
X........P.....X...X
X.XX.XXX.X.XXX.XXX.X
X....X.......X.....X
X.XXXXXXXXXXXXXXXX.X
X........X.........X
XXXOXXXX.X.XXXXOXXXX
  XXX  X X X  XXX   
                        "Tw1st3d" by Matt Bell