XXXXXXXXXXXXXXXXXXXX
XO.......XX.......OX
X.XXXXX......XXXXX.X
X.....X..XX. X.....X
X..XX....XX....XX..X       
X.....XXXXXXXX.....X
XXX...XG     X...XXX
X.....XXXXXXXX.....X
X.XXX.X..S...X.XXX.X
XO..X...XXXX...X..OX
XXX...XXXXXXXX...XXX
X...X....P.....X...X
X..XX.XXXXXXXX.XX..X
X..................X
X..X..XX.XX.XX..X..X
XX..OXX......XXO..XX
X..X....XXXX....X..X
X.XXXXX.XXXX.XXXXX.X
XO................OX
XXXXXXXXXXXXXXXXXXXX
                        "off the hizzle" by Neil Of Doom